4 13 31
###############################
#p    * **    *   3   4       #
# # # #*# # # # # # # # # # # #
#      ** * *  *   * f* 3 *   #
# # # # # #*# # # # # # #*# # #
#*   * *    *b* *   **        #
# # # # # # # # # # # # # #*# #
#    *     *   *    *    **  3#
# #*# # #*#*#*#*# # #1# # #*# #
#    *   * 4 *2*    *   *     #
#*# # # # # # # # # # #*# # #*#
#x*    * **    ** ***     1   #
###############################